tags: sogang classroom
(1) 이 (2) 저 (3)그 (문법)| used for object or person. (1) used when it's near the speaker (2) when it's far from the speaker and listener but in sight (3) when it's far from the speaker and close to the listener or out of sight (grammar)
칸|a space
동작|action/motion
곳|place
매일|every day
주중|weekdays
복습하다|to review
예습하다|to preview
준비하다|to prepare
단어를 외우다|to memorise words
알겠어요|I see
대화|dialogue
과제|task
과|unit
이용하다|to use
글자|letter/character
설명하다|to explain
활동|activity
맞다|to be correct
틀리다|to be incorrect
내용|contents
요약하다|to summarise
알아맞히다|to guess/find out
본문|the main text
표시하다|to mark/tick
빈칸을 채우다|to fill in the blank
따라하다|to follow/repeat
요약문|summary
완성하다|to complete
부사|adverb
기타|etcetera
동사|verb
형용사|adjective
명사|noun
표현|expression
문법|grammar
